11111111
10000001
11110111
10000111
100N0111
10000011
11111111
