11111111
10000001
10110011
101N1001
11111111
