11111111
10000001
11010111
1000011
100N011
10000011
10010001
10000001
11111111
