11111111
10000001
11010111
10000111
100N0111
10000011
10010001
10000001
11111111