111111111
101000101
1111C1111
101000101
10C0N0C01
101000101
1111C1111
101000101
111111111
