       1
      101
     10001
    1000001
   100000001
  10000000001
 1000000000001
1000000N0000001
 1000000000001
  10000000001
   100000001
    1000001
     10001
      101
       1
