11111111
10000001
11111111
100001111011
100N01101
10000011
11111111
