11111111
10000001
10100011
100N0001
11111111
